000000000000000000000000000000000000000000000000000000000000000000000000000000000000000000000000000000000000000
000000000000000000000000000000000000000000000000000000000000000000000000000000000000000000000000000000000000000
000000000000002222200000000000000000000000000000000000000000000000000000000000000000000000000000000000000000
000002220000000000000000000000000000000000000000000000000000000000300000000000000000000000000000000000000000000
000000000000000000000000000000000000000000000000000000000000002222222000000000000000000000000000000000000000000
00000000000000000000000000000000222220000000000000000000000000000000000000000000000000000000000000000000000222
000000000000000000000000222000000000000000000000000000000000000000000000000000000000000000000000000222222222111
00000000000000222220000000000000000000022222000000000000000000000000000022222222222220000000002111111111111
000030000000000000000000000000000000000000000000000000000000000000000000000211111111111112222222221111111111111
002222200000000000000000000000000000000000000000000000000000000000002222222111111111111111111111111111111111111
000000000000000300000000000000000000000000000000000000000002222222221111111111111111111111111111111111111111111
000000000000222220000000000000000000000022222222200000011111111111111111111111111111111111111111111111111111111
000000000000000000000000002222222222222211111111100000011111111111111111111111111111111111111111111111111111111
000300030000000300000022221111111111111111111111000000011111111111111111111111111111111111111111111111111111111
222222222222222222222211111111111111111111111111000001111111111111111111111111111111111111111111111111111111111
111111111111111111111111111111111111111111111110000001111111111111111111111111111111111111111111111111111111111
111111111111111111111111111111111111111111111110000001111111111111111111111111111111111111111111111111111111111
111111111111111111111111111111111111111111111100000011111111111111111111111111111111111111111111111111111111111
111111111111111111111111111111111111111111111000001111111111111111111111111111111111111111111111111111111111111
111111111111111111111111111111111111111111110000001111111111111111111111111111111111111111111111111111111111111