10000000000000000001
10000000000000000001
12222200000022222001
11111000000011110001
11100000000001100001
11003330000000000001
10033333000000022221
10003330000000000111
10000300000000000001
10000000000222222221
12222000000011111111
11110000000000000001
11000000000000000001
10000000222222220001
10000000011111100001
10000000000111002221
12220000000000000001
11111200002222222001
1111122221111111221
11111111111111111111