33333333333333333333
30000000000000000003
30333333000333333303
30000000000000000303
30000333333303300303
30033333333303300303
30000333333300000303
30000000000000000003
30000033330333333333
33000000330000000003
33330000030003330003
33000000330033333003
30000033333003300003
30000000033000000003
33000000033333330003
33333300000000000003
33000000000000003303
30000033333330000033
30000033333333333333
33333333333333333333