10000000000000000001
10000003300000000001
12222200000022222001
11111000000011110001
11100000000001100001
11003330000000000001
10033333000000022221
10000000003330000111
10000000000000000001
12222000000222222001
33333300003333330003
33333000000333300333
30000000000333300033
30000033300033000003
30003300000003300333
30033000000000000003
30000333333330000003
30000000000000022223
32222222222222211113
31111111111111111113