33333333333333333333
30000000000000000003
30000000000000000003
30000000000333330003
33333333300000000003
33333333000003000003
33300000000033300033
33000000000033333333
33003333300000333303
30033300000000000003
33333300003333330003
33333000000333300003
30000000000333300003
30000033300000000003
33333300000003333333
33333000000000000003
30000000000000000003
30000333333330000003
30000000000000000003
33333333333333333333