00000000000000000000
40000000000000000004
40000000000000000004
40000000000000000004
40000000000000000004
40000000000000000004
40000000000000000004
40000000000000000004
40000000000000000004
40000000000000000004
40000000000000000004
40000000000000000004
40000000000000000004
40000000000000000004
40000000000000000004
40000000000000000004
40000000000000000004
40000000000000000004
40000000000000000004
44444444444444444444