4444444444444444444
40000000000000000004
40000000000000044444
44444400000000000004
40000000000000000004
40000004444400000004
40000000000000000004
40000000000000044444
40000000000000000004
44004444000000000004
40000400000000000004
40040000000444440004
40000000000000000004
44004440000000440004
40000000000000000004
40000004004040000004
40004444444444440004
44400000000000000004
44400000000000004444
44444444444444444444